5	5	5	5	5	5	5	5	5	5	5	5	5	5	5	5	5	5	5	5	5	5	5	5	5	5	5	5	5	5
5	2	2	2	2	2	2	2	2	2	2	2	2	2	2	2	5	2	4	4	4	2	2	2	2	2	2	2	2	5
5	2	3	2	2	2	3	2	3	3	3	2	3	2	2	3	5	2	2	3	4	2	3	2	2	2	3	2	2	5
5	2	3	3	2	2	3	2	2	3	2	2	3	2	2	3	5	2	2	3	4	2	3	3	2	3	3	2	2	5
5	2	3	2	3	2	3	2	6	3	2	2	3	2	2	3	5	2	2	3	2	2	3	2	3	2	3	2	2	5
5	2	3	2	2	3	3	2	6	3	2	5	3	2	2	3	6	2	2	3	2	2	3	2	2	2	3	2	2	5
5	2	3	2	2	2	3	2	6	3	2	2	3	3	3	3	6	2	2	3	5	5	3	2	2	2	3	2	2	5
5	2	6	6	2	2	2	2	2	4	4	5	4	4	4	4	6	2	2	2	2	5	5	2	2	2	2	2	2	5
5	2	2	2	2	2	2	2	2	4	4	4	4	4	4	4	6	2	2	2	2	2	2	2	2	2	2	2	2	5
5	2	2	2	2	2	2	2	2	2	2	2	2	2	2	2	5	2	2	2	2	2	2	2	2	2	2	2	2	5
5	2	2	2	2	2	2	2	2	2	2	2	2	2	2	2	5	2	2	2	2	2	2	2	5	6	6	6	6	5
5	6	6	6	6	6	5	2	2	2	2	5	2	2	2	2	5	2	2	2	2	2	2	2	5	2	2	2	2	5
5	2	2	2	2	2	5	2	2	2	2	2	5	2	2	6	5	2	2	2	2	2	2	2	5	2	4	4	4	5
5	4	4	4	2	2	5	2	2	2	2	2	6	5	2	6	6	2	2	2	2	2	2	2	5	2	4	2	2	5
5	2	2	4	2	2	5	2	2	2	2	2	6	6	5	6	6	2	2	2	2	2	2	2	5	2	4	2	1	5
5	0	2	4	2	2	5	2	2	2	2	2	6	6	2	5	6	2	2	2	2	2	2	2	5	2	4	2	2	5
5	2	2	4	2	2	5	2	2	2	2	2	2	6	2	2	5	2	2	2	2	2	2	2	5	2	4	4	4	5
5	4	4	4	2	2	5	2	2	2	2	2	2	5	2	2	2	5	2	2	2	2	2	2	5	2	2	2	2	5
5	2	2	2	2	2	5	2	2	2	2	2	2	5	2	2	2	2	5	2	2	2	2	2	5	6	6	6	6	5
5	6	6	6	6	6	5	2	2	2	2	2	2	5	2	2	2	2	2	2	2	2	2	2	2	2	2	2	2	5
5	2	2	2	2	2	2	2	2	2	2	2	2	5	2	2	2	2	2	2	2	2	2	2	2	2	2	2	2	5
5	2	2	2	2	2	2	2	2	2	2	2	2	6	4	4	4	4	4	4	4	2	2	2	2	2	2	2	2	5
5	2	2	2	2	2	2	2	2	5	2	2	2	6	4	4	4	4	4	4	4	2	2	2	2	2	2	2	2	5
5	2	2	2	2	2	2	2	2	5	2	2	2	6	2	2	2	2	2	2	2	2	2	2	5	5	5	5	5	5
5	2	2	2	2	2	2	2	2	5	2	2	2	6	2	2	2	2	2	2	2	2	2	2	2	2	2	2	2	5
5	2	2	4	2	2	2	2	5	2	2	2	2	5	2	2	2	2	2	5	2	2	2	2	2	2	2	2	2	5
5	2	4	2	4	2	2	2	2	2	2	2	2	5	2	2	2	2	2	5	2	2	2	2	2	2	2	2	2	5
5	4	2	2	2	4	2	2	2	2	2	2	2	5	2	2	2	2	2	2	2	2	2	2	2	2	2	2	2	5
5	2	2	2	2	2	2	2	2	2	2	2	2	5	2	2	2	2	2	2	2	2	2	2	2	2	2	2	2	5
5	5	5	5	5	5	5	5	5	5	5	5	5	5	5	5	5	5	5	5	5	5	5	5	5	5	5	5	5	5