4	4	4	4	4	4	2	2	2	2	2	2	2	2	6	6	2	2	5	2	2	2	2	2	2	2	6	6	2	1
4	2	2	2	2	2	2	2	2	2	2	2	2	2	6	6	2	5	2	2	2	2	2	2	2	2	6	6	2	2
4	2	5	2	2	5	2	2	4	4	4	4	4	5	2	2	5	2	2	2	2	5	5	5	5	5	5	5	6	6
4	2	2	2	2	2	2	2	4	4	4	4	4	5	2	2	5	2	2	2	5	2	2	2	2	2	2	5	6	6
4	2	2	2	2	2	2	2	4	4	4	4	4	5	2	2	2	2	2	5	6	6	2	2	2	2	2	5	2	2
4	2	5	2	2	5	2	2	4	4	4	4	4	5	2	2	2	2	5	2	6	6	5	5	2	2	2	5	2	2
2	2	2	2	2	2	6	6	2	2	4	4	4	5	2	2	2	5	2	2	6	6	2	2	5	2	2	5	2	2
2	2	2	2	2	2	6	6	2	2	2	4	4	5	2	2	5	2	2	2	5	2	2	2	5	2	2	2	2	2
2	2	4	4	4	4	2	2	5	2	2	2	4	5	2	2	5	2	2	5	5	2	2	2	5	2	2	2	2	5
2	2	4	4	4	4	2	2	2	5	2	2	2	5	5	5	5	2	2	2	5	2	2	2	2	5	2	2	5	2
2	2	4	4	4	4	4	2	2	2	5	2	2	2	6	6	5	2	2	2	2	5	2	2	2	2	5	5	2	2
2	2	4	4	4	4	4	4	2	2	2	5	2	2	6	6	5	2	2	2	2	2	5	2	2	2	5	2	2	2
2	2	4	4	4	4	4	4	4	2	2	2	5	3	3	3	3	5	2	2	2	2	2	5	2	2	5	2	2	2
2	2	5	5	5	5	5	5	5	5	2	2	3	3	3	3	3	3	5	5	5	5	5	5	2	2	2	2	2	5
6	6	2	2	2	2	2	2	2	5	6	6	3	3	3	3	3	3	6	6	2	2	2	2	6	6	2	2	5	2
6	6	2	2	2	2	2	2	2	5	6	6	3	3	3	3	3	3	6	6	2	2	2	2	6	6	2	5	2	2
2	2	5	5	5	5	5	5	5	5	5	5	3	3	3	3	3	3	5	5	5	5	5	5	2	2	5	2	2	2
2	2	5	2	2	2	2	2	2	2	2	2	5	3	3	3	3	5	2	2	2	2	2	2	2	2	5	2	2	2
2	2	5	2	2	2	2	2	2	2	2	2	2	5	6	6	5	2	2	2	2	2	2	2	2	2	2	5	2	2
2	2	5	5	5	5	5	5	5	2	2	2	2	5	6	6	5	2	2	5	5	5	2	2	2	2	2	2	5	2
2	2	2	2	2	2	6	6	2	2	2	2	5	5	2	2	5	2	2	5	2	2	5	5	5	2	2	2	5	2
2	2	2	2	2	2	6	6	2	2	2	5	2	5	2	2	5	2	2	5	5	2	2	2	2	5	2	2	5	2
5	5	5	5	5	5	2	2	5	5	5	2	2	5	2	2	5	2	2	2	2	5	2	2	2	5	2	2	5	5
2	2	2	2	2	2	2	2	5	2	2	2	5	2	2	2	5	2	2	2	6	6	5	5	5	2	6	6	2	2
2	2	2	2	2	2	2	2	5	2	2	2	5	2	2	2	2	5	5	5	6	6	2	2	2	2	6	6	2	2
2	2	5	5	5	5	5	5	5	2	2	2	5	5	2	2	2	2	2	2	2	2	2	2	2	2	2	5	2	2
6	6	5	2	2	2	2	2	2	6	6	6	2	2	5	2	2	2	2	2	2	2	2	2	2	2	2	5	2	2
6	6	5	5	5	5	5	5	5	6	6	6	2	2	5	5	5	5	5	5	5	5	5	5	5	5	5	5	2	2
2	2	6	6	2	2	2	2	2	2	2	5	2	2	2	2	2	2	2	2	2	2	2	2	2	2	2	2	2	2
0	2	6	6	2	2	2	2	2	2	2	5	2	2	2	2	2	2	2	2	2	2	2	2	2	2	2	2	2	2