5	5	5	5	5	5	5	5	5	5	5	5	5	5	5	5	5	5	5	5	5	5	5	5	5	5	5	5	5	5
5	4	4	4	4	4	4	4	4	5	5	4	4	4	4	4	4	4	4	5	5	4	4	4	4	4	4	4	4	5
5	4	6	6	6	6	6	6	6	2	2	2	2	2	4	2	2	2	2	2	2	6	6	6	6	6	6	6	4	5
5	4	6	6	6	4	2	2	2	2	2	4	2	2	2	2	2	2	2	2	4	4	4	4	2	6	6	6	4	5
5	4	6	6	6	4	2	2	2	2	2	5	2	2	2	4	2	2	2	2	4	2	2	2	2	6	6	6	4	5
5	4	6	4	4	4	2	2	2	2	2	2	2	2	2	2	2	2	2	2	4	2	2	2	1	4	2	6	4	5
5	4	6	2	2	2	2	2	2	2	2	5	2	2	4	2	2	2	4	2	4	2	2	2	2	4	2	6	4	5
5	4	6	2	2	4	2	2	5	4	2	2	2	2	2	2	2	2	2	2	4	4	2	2	2	4	2	6	4	5
5	4	6	2	2	2	2	2	2	2	2	2	2	2	2	2	2	2	2	2	4	2	2	2	2	2	2	6	4	5
5	5	2	4	4	4	4	4	4	2	2	2	2	2	2	2	5	2	2	2	2	2	2	5	5	2	2	2	5	5
5	5	2	2	2	2	2	2	2	5	2	2	2	5	2	2	2	2	2	2	2	4	5	2	2	2	2	4	5	5
5	4	2	2	5	2	2	2	2	2	5	2	2	2	2	2	2	2	2	5	2	2	4	4	2	2	2	2	4	5
5	4	2	2	2	2	2	2	2	4	2	2	2	2	2	2	2	5	2	2	2	2	2	2	2	2	2	2	4	5
5	4	2	2	2	2	4	4	2	2	2	2	2	6	6	6	6	2	2	2	2	5	2	2	5	2	2	5	4	5
5	4	4	2	2	2	2	2	2	4	2	2	2	6	4	4	6	2	2	2	2	2	2	2	2	2	2	2	4	5
5	4	2	2	2	2	2	2	2	5	2	2	2	6	4	4	6	2	2	2	2	4	2	2	2	2	5	2	4	5
5	4	2	5	2	2	4	2	2	5	2	2	2	6	6	6	6	2	2	2	5	2	2	2	2	2	2	2	4	5
5	4	2	5	2	2	2	2	2	2	2	4	2	2	2	2	2	2	2	2	2	2	2	2	5	2	2	2	4	5
5	4	2	2	2	5	2	2	2	2	2	4	2	2	2	2	5	2	2	5	2	2	4	2	2	2	2	2	4	5
5	5	5	2	2	5	2	2	2	2	2	2	2	4	2	2	2	2	2	2	2	2	2	2	2	2	2	2	5	5
5	5	2	2	2	2	2	2	2	2	2	5	2	2	2	2	2	2	2	2	2	4	4	4	4	4	4	2	5	5
5	4	6	2	2	2	2	2	5	4	2	2	2	2	2	2	2	2	2	2	2	2	2	2	2	2	2	6	4	5
5	4	6	2	4	2	2	2	2	4	2	2	2	2	2	2	2	5	2	5	2	2	2	4	2	2	2	6	4	5
5	4	6	2	2	2	2	5	2	4	2	4	2	2	2	2	2	2	2	2	2	2	5	2	4	4	2	6	4	5
5	4	6	4	2	0	2	2	2	4	2	2	2	4	2	2	2	2	2	2	2	2	2	2	4	4	2	6	4	5
5	4	6	6	6	2	2	2	2	4	2	2	2	2	2	2	2	4	2	2	2	4	2	2	2	6	6	6	4	5
5	4	6	6	6	2	2	4	2	4	2	2	2	2	2	2	2	2	2	2	5	2	2	2	2	6	6	6	4	5
5	4	6	6	6	6	6	6	6	2	2	5	2	2	2	2	4	2	2	2	2	6	6	6	6	6	6	6	4	5
5	4	4	4	4	4	4	4	4	5	5	4	4	4	4	4	4	4	4	5	5	4	4	4	4	4	4	4	4	5
5	5	5	5	5	5	5	5	5	5	5	5	5	5	5	5	5	5	5	5	5	5	5	5	5	5	5	5	5	5