2	2	2	2	2	2	2	2	2	2	2	2	2	2	2	2	2	2	2	2	2	2	2	2	2	2	2	2	2	2
2	2	2	2	2	2	2	2	2	2	2	2	2	2	2	2	2	2	2	2	2	2	2	2	2	2	2	6	2	2
2	2	2	2	2	2	2	2	2	2	2	2	2	6	2	2	2	2	6	2	2	2	2	2	2	2	6	5	6	2
2	2	2	5	4	2	2	5	4	2	2	2	6	5	6	2	2	6	5	6	2	2	5	5	4	2	2	6	2	2
2	2	2	2	5	4	5	4	2	2	2	2	2	6	2	2	2	2	6	2	2	2	5	4	5	4	2	2	2	2
2	2	2	2	2	5	4	2	2	2	2	2	2	2	2	2	2	2	2	2	2	2	5	4	2	5	4	2	2	2
2	2	2	2	5	4	5	4	2	2	2	2	2	2	2	2	2	2	2	2	2	2	5	4	5	4	2	2	2	2
2	2	2	5	4	2	2	5	4	2	2	2	6	2	2	2	2	2	2	2	2	2	5	5	4	2	2	2	2	2
2	6	2	2	2	2	2	2	2	2	2	6	5	6	2	2	2	2	6	2	2	2	2	2	6	2	2	2	2	2
6	5	6	2	2	2	2	2	2	2	2	2	6	2	2	2	2	6	5	6	2	2	2	6	5	6	2	2	2	2
2	6	2	2	2	2	2	2	2	2	2	2	2	2	2	2	2	2	6	2	2	2	2	2	6	2	2	2	2	2
2	2	2	2	2	2	2	2	2	2	2	6	2	2	2	2	2	2	2	2	2	2	2	2	2	2	2	2	2	2
2	2	2	2	2	2	2	6	2	2	6	5	6	2	2	5	4	2	2	2	2	2	2	2	2	2	3	2	2	2
2	2	2	3	2	2	6	5	6	2	2	6	2	2	5	4	2	2	6	2	2	2	2	2	2	3	3	3	2	2
2	2	3	3	3	2	2	6	2	2	2	2	2	5	4	2	2	6	5	6	2	2	2	2	3	3	1	3	3	2
2	3	3	0	3	3	2	2	2	6	2	2	2	2	5	4	2	2	6	2	2	2	2	2	2	3	3	3	2	2
2	2	3	3	3	2	2	2	6	5	6	2	2	2	2	5	4	2	2	2	2	2	2	2	2	2	3	2	2	2
2	2	2	3	2	2	2	2	2	6	2	2	2	2	2	2	6	2	2	2	2	2	6	2	2	2	2	2	2	2
2	2	2	2	2	2	2	2	2	2	2	2	2	2	2	6	5	6	2	2	2	6	5	6	2	2	2	2	6	2
2	2	2	2	2	2	2	2	2	2	2	2	2	2	2	2	6	2	2	2	2	2	6	2	2	2	2	6	5	6
2	6	2	2	2	2	2	2	2	2	6	2	2	2	2	2	2	2	2	2	2	2	2	5	2	2	2	2	6	2
6	5	6	2	2	2	2	2	2	6	5	6	2	2	2	2	2	2	5	2	2	2	2	2	2	2	2	2	2	2
2	6	2	2	2	2	2	2	2	2	6	2	2	2	2	2	2	2	6	2	2	2	2	2	2	2	2	2	2	2
2	5	2	2	2	5	4	2	2	2	2	2	2	2	2	2	2	6	5	6	2	2	2	2	5	4	2	2	2	2
2	2	2	2	2	2	5	4	2	2	2	2	2	2	2	2	2	2	6	2	2	2	2	5	4	2	2	2	2	2
2	2	2	2	5	2	2	5	4	2	2	2	2	2	2	2	2	2	2	2	2	2	5	4	2	2	2	2	2	2
2	2	6	2	2	2	2	2	5	5	5	5	5	5	5	5	5	5	5	5	5	5	4	2	2	2	2	2	2	2
2	6	5	6	2	2	2	2	2	2	2	2	2	2	2	2	2	2	2	2	2	2	2	2	2	2	6	2	2	2
2	2	6	2	2	2	2	2	2	2	2	2	2	2	2	2	2	2	2	2	2	2	2	2	2	6	5	6	2	2
2	2	2	2	2	2	2	2	2	2	2	2	2	2	2	2	2	2	2	2	2	2	2	2	2	2	6	2	2	2